10 10
7 8
2 7
1 2 3 0 4 5 3 2 0 2
1 2 5 0 4 5 3 2 0 2
1 2 3 0 4 0 3 2 0 2
4 2 3 0 4 5 1 2 0 2
3 2 3 0 1 5 3 2 0 2
1 1 3 3 1 5 3 2 0 2
1 2 3 0 4 4 0 2 0 2
1 0 3 0 4 4 5 3 2 2
1 2 3 0 4 5 3 2 0 2
1 2 3 0 4 5 3 2 0 2