5 5
0 3
4 1
1 2 0 4 3
1 5 3 2 0
2 0 4 1 3
3 2 0 0 2
4 3 2 2 1