5 5
1 2
4 4
2 4 2 1 4
0 1 2 3 5
2 0 4 4 1
2 5 5 0 0
4 3 3 0 1